1111111111111111111111111
1001000001000000000000C01
1E01000C010000100000F0001
1000001111CF000000100C001
10000000000000C0011000001
100C00P000000000001C00001
1111111111111111111111111