11111111111111111111111111
10010000010000000000000001
1001000001000010000000F001
1000E01111C000000010000001
10000000000000C00010000001
100C00P0000000000010000001
11111111111111111111111111