11111111111111111111111111
1C010000C10000C0000000C001
1001000001000010000000F001
1000001111C0000000100E0001
10000000000000C000100C0001
100C00P00000000000100000C1
11111111111111111111111111