11111111111111111111111111
1C010000C10000C0000000C001
10010000010000100000000001
1000001111C0000000100E0001
100000000F0000C000100C0001
100C00P0000000000010000001
11111111111111111111111111