1111111111111111111111111
1001000001000000000000C01
1001000C01000010000000001
1000E01111C0000000100C001
10000000000000C0011000001
100C00P0000F0000001C00001
1111111111111111111111111